11111111111111111111111111111111
      1 1   1       1         11
1 11111 1 111 1 1111111 1 111 11
1 1   1     1 1 1     1 1   1 11
1 1 1 11111 1 111 11111 11111 11
1   1           1 1 1   1   1 11
1211111111111 111 1 1 1 1 1 1 11
1     1               1   1 1 11
1 1 1 11111 1 1 11111111111 1111
1 1 1 1     1 1         1 1   11
1 1 1111111 1 1 111111111 111 11
1 1     1   1 1 1 1   1 1     11
1 1 111 111 1 111 1 111 1 111111
1 1 1   1 1 1 1         1     11
1 111 111 1 1 1111111 1111111 11
1 1 1 1     1   1         1   11
1 1 1 111111111 1111111 111 1111
1   1       1     1       1 1 11
12111 1 1 1 11111 11111 11111 11
1 1   1 1 1 1   1         1   11
1 111111111 1 1 11111 1111111 11
1   1     1 1 1 1       1   1 11
1 111 1 111 1 11111 111 1 111 11
1 1   1     1   1   1 1     1 11
1 11111 111 111 11111 1 1 111 11
1   1 1   1   1 1     1 1     11
1 111 1111111 1 1 1 111 111 1111
1   1 1 1     1   1 1 1 1 1   11
121 1 1 1 1 1 111 111 1 1 111 11
1         2 2             2    s
11111111111111111111111111111111
11111111111111111111111111111111
