11111111111111111111111111111111
111111111                      1
111   111                      1
11     11                      1
11  s  2                       1
11     11                      1
111   111                      1
111111111                      1
1                              1
1                              1
1                              1
1                              1
1                              1
1                              1
1                              1
1                              1
1                              1
1                              1
1                              1
1                              1
1                              1
1                              1
1                              1
1                              1
1                              1
1                              1
1                              1
1                              1
1                              1
1                              1
1                              1
11111111111111111111111111111111
